65
52
0
2
===========================
-1 -1 1 -1 -1 -1 0 -1 -1 -1 
1 0 12 0 1 0 12 0 1 1 
-1 -1 0 -1 -1 -1 0 -1 -1 -1 
1 0 12 0 1 0 12 0 1 1 
-1 -1 0 -1 -1 -1 0 -1 -1 -1 
---------------------------
0 0 0 0 0 0 0 0 0 0 
0 0 5 0 0 0 5 0 0 0 
0 0 0 0 0 0 0 0 0 0 
0 0 5 0 0 0 5 0 0 0 
0 0 0 0 0 0 0 0 0 0 
%%%%%%%%%%%%%%%%%%%%%%%%%%%%
