87
16
0
0
===========================
11 11 11 11 11 11 11 11 11 11 
11 -1 -1 -1 11 11 -1 -1 -1 11 
11 -1 1 1 1 1 1 1 -1 11 
11 11 2 1 1 1 1 2 11 11 
11 -1 1 1 13 13 1 1 -1 11 
---------------------------
0 0 0 0 0 0 0 0 0 0 
0 0 0 0 0 0 0 0 0 0 
0 0 0 0 0 0 0 0 0 0 
0 0 0 0 0 0 0 0 0 0 
0 0 0 0 0 0 0 0 0 0 
%%%%%%%%%%%%%%%%%%%%%%%%%%%%
