97
67
2
5
===========================
-1 1 1 1 1 1 1 1 1 -1 
1 -1 -1 1 1 1 1 -1 -1 1 
12 12 12 12 12 12 12 12 12 12 
1 -1 -1 1 1 1 1 -1 -1 1 
-1 13 13 13 13 13 13 13 13 -1 
---------------------------
0 0 0 0 0 0 0 0 0 0 
0 0 0 0 0 0 0 0 0 0 
11 20 4 24 5 2 5 11 3 6 
6 0 0 0 0 0 0 0 0 0 
0 0 0 0 0 0 0 0 0 0 
%%%%%%%%%%%%%%%%%%%%%%%%%%%%
