75
45
2
4
===========================
-1 -1 2 0 1 1 0 2 -1 -1 
-1 2 1 1 13 11 1 1 2 -1 
-1 1 11 11 11 11 11 11 1 -1 
-1 2 1 1 13 11 1 1 2 -1 
-1 -1 2 0 1 1 0 2 -1 -1 
---------------------------
0 0 0 0 0 0 0 0 0 0 
0 0 0 0 0 0 0 0 0 0 
0 0 0 0 0 0 0 0 0 0 
0 0 0 0 0 0 0 0 0 0 
0 0 0 0 0 0 0 0 0 0 
%%%%%%%%%%%%%%%%%%%%%%%%%%%%
