74
62
2
7
===========================
1 1 1 13 1 1 1 1 1 1 
1 1 1 1 1 12 1 1 1 1 
1 13 1 1 1 1 1 13 1 1 
1 1 1 1 13 1 1 1 1 1 
1 1 1 1 1 1 13 1 1 1 
---------------------------
0 0 0 0 0 0 0 0 0 0 
0 0 0 0 0 40 0 0 0 0 
0 0 0 0 0 0 0 0 0 0 
0 0 0 0 0 0 0 0 0 0 
0 0 40 0 0 0 0 0 0 0 
%%%%%%%%%%%%%%%%%%%%%%%%%%%%
