95
56
1
9
===========================
1 13 1 1 1 1 1 1 1 13 
1 1 1 1 1 1 13 1 1 1 
-1 -1 13 1 1 1 1 1 1 13 
1 -1 -1 1 1 13 -1 -1 -1 -1 
-1 -1 1 -1 13 1 1 -1 -1 0 
---------------------------
1 1 1 1 1 1 1 1 1 1 
1 1 1 1 1 1 1 1 1 1 
1 1 1 1 1 1 1 1 1 1 
1 1 1 1 1 1 1 1 1 1 
1 1 1 1 1 1 1 1 1 1 
%%%%%%%%%%%%%%%%%%%%%%%%%%%%
