93
55
0
0
===========================
11 11 0 6 0 11 11 13 0 4 
11 11 11 0 11 0 11 1 1 0 
1 11 11 11 0 7 0 11 1 1 
0 11 11 11 11 0 11 11 11 11 
6 0 11 11 11 13 11 11 11 11 
---------------------------
0 0 0 0 0 0 0 0 0 0 
0 0 0 0 0 0 0 0 0 0 
0 0 0 0 0 0 0 0 0 0 
0 0 0 0 0 0 0 0 0 0 
0 0 0 0 0 0 0 0 0 0 
%%%%%%%%%%%%%%%%%%%%%%%%%%%%
