78
27
4
1
===========================
-1 -1 -1 -1 -1 -1 -1 -1 -1 -1 
-1 4 1 1 1 1 1 -1 -1 -1 
-1 1 13 13 13 13 1 -1 -1 -1 
-1 1 13 13 13 13 1 -1 -1 -1 
-1 1 1 1 1 1 4 -1 -1 -1 
---------------------------
0 0 0 0 0 0 0 0 0 0 
0 0 0 0 0 0 0 0 0 0 
0 0 0 0 0 0 0 0 0 0 
0 0 0 0 0 0 0 0 0 0 
0 0 0 0 0 0 0 0 0 0 
%%%%%%%%%%%%%%%%%%%%%%%%%%%%
