76
50
2
0
===========================
-1 1 1 1 12 12 1 1 1 13 
-1 1 1 1 -1 11 1 0 1 11 
11 -1 0 0 0 11 1 1 -1 -1 
11 11 11 11 11 11 11 -1 -1 -1 
13 1 0 1 0 0 1 1 8 -1 
---------------------------
0 0 0 0 7 25 0 0 0 0 
0 0 0 0 0 0 0 0 0 0 
0 0 0 0 0 0 0 0 0 0 
0 0 0 0 0 0 0 0 0 0 
0 0 0 0 0 0 0 0 0 0 
%%%%%%%%%%%%%%%%%%%%%%%%%%%%
