64
19
4
5
===========================
0 0 -1 -1 1 0 -1 -1 0 0 
1 1 -1 -1 -1 -1 -1 -1 1 1 
1 13 11 11 11 11 11 11 13 1 
1 1 -1 -1 13 13 -1 -1 0 0 
0 0 -1 -1 11 11 -1 -1 0 0 
---------------------------
0 0 0 0 0 0 0 0 0 0 
0 0 0 0 0 0 0 0 0 0 
0 0 0 0 0 0 0 0 0 0 
0 0 0 0 0 0 0 0 0 0 
0 0 0 0 0 0 0 0 0 0 
%%%%%%%%%%%%%%%%%%%%%%%%%%%%
