77
19
2
4
===========================
-1 -1 -1 -1 0 -1 -1 -1 -1 -1 
-1 -1 -1 1 0 1 -1 -1 -1 -1 
-1 -1 0 1 13 1 0 -1 -1 -1 
-1 -1 -1 1 0 1 -1 -1 -1 -1 
-1 -1 -1 -1 0 -1 -1 -1 -1 -1 
---------------------------
0 0 0 0 0 0 0 0 0 0 
0 0 0 0 0 0 0 0 0 0 
0 0 0 0 0 0 0 0 0 0 
0 0 0 0 0 0 0 0 0 0 
0 0 0 0 0 0 0 0 0 0 
%%%%%%%%%%%%%%%%%%%%%%%%%%%%
