83
30
0
4
===========================
11 11 11 11 11 11 11 11 11 11 
13 13 13 13 13 13 13 13 11 11 
1 1 1 1 12 1 1 1 13 11 
12 1 1 1 1 1 12 1 13 11 
1 1 12 1 1 1 1 1 13 11 
---------------------------
0 0 0 0 0 0 0 0 0 0 
0 0 0 0 0 0 0 0 0 0 
0 0 0 0 6 0 0 0 0 0 
18 0 0 0 0 0 23 0 0 0 
0 0 6 0 0 0 0 0 0 0 
%%%%%%%%%%%%%%%%%%%%%%%%%%%%
