82
25
4
9
===========================
-1 11 11 11 11 11 11 11 -1 -1 
-1 11 -1 0 0 0 1 11 -1 -1 
-1 1 1 1 -1 -1 1 11 11 11 
-1 1 12 1 -1 -1 0 0 0 11 
-1 1 1 1 -1 -1 -1 -1 6 11 
---------------------------
0 0 0 0 0 0 0 0 0 0 
0 0 0 0 0 0 0 0 0 0 
0 0 0 0 0 0 0 0 0 0 
0 0 15 0 0 0 0 0 0 0 
0 0 0 0 0 0 0 0 0 0 
%%%%%%%%%%%%%%%%%%%%%%%%%%%%
