55
15
4
4
===========================
13 1 1 1 1 1 1 1 -1 -1 
11 1 1 1 1 1 1 1 13 11 
11 -1 -1 13 1 1 1 1 1 11 
11 -1 -1 -1 -1 -1 11 11 11 12 
11 11 11 11 11 11 11 -1 -1 -1 
---------------------------
0 0 0 0 0 0 0 0 0 0 
0 0 0 0 0 0 0 0 0 0 
0 0 0 0 0 0 0 0 0 0 
0 0 0 0 0 0 0 0 0 19 
0 0 0 0 0 0 0 0 0 0 
%%%%%%%%%%%%%%%%%%%%%%%%%%%%
