61
44
2
5
===========================
-1 1 1 1 -1 -1 1 1 1 -1 
1 1 1 1 1 1 1 1 1 1 
1 1 1 1 11 11 1 1 1 1 
1 1 1 1 1 1 1 1 1 1 
-1 1 1 1 -1 -1 1 1 1 -1 
---------------------------
0 0 0 0 0 0 0 0 0 0 
0 0 0 0 0 0 0 0 0 0 
0 0 0 0 0 0 0 0 0 0 
0 0 0 0 0 0 0 0 0 0 
0 0 0 0 0 0 0 0 0 0 
%%%%%%%%%%%%%%%%%%%%%%%%%%%%
