57
35
2
9
===========================
12 1 11 11 1 1 1 11 11 13 
-1 -1 -1 -1 1 12 1 -1 11 12 
-1 -1 -1 -1 -1 -1 -1 11 11 11 
12 1 1 -1 11 13 11 1 1 1 
1 1 1 11 11 12 13 1 1 1 
---------------------------
10 0 0 0 0 0 0 0 0 0 
0 0 0 0 0 7 0 0 0 1 
0 0 0 0 0 0 0 0 0 0 
10 0 0 0 0 0 0 0 0 0 
0 0 0 0 0 7 0 0 0 0 
%%%%%%%%%%%%%%%%%%%%%%%%%%%%
