63
31
2
1
===========================
-1 1 2 1 1 1 1 2 1 -1 
1 11 11 11 11 11 11 11 11 1 
2 11 13 2 2 2 2 13 11 2 
1 11 11 11 11 11 11 11 11 1 
-1 1 2 1 1 1 1 2 1 -1 
---------------------------
0 0 0 0 0 0 0 0 0 0 
0 0 0 0 0 0 0 0 0 0 
0 0 0 0 0 0 0 0 0 0 
0 0 0 0 0 0 0 0 0 0 
0 0 0 0 0 0 0 0 0 0 
%%%%%%%%%%%%%%%%%%%%%%%%%%%%
