69
45
2
7
===========================
1 0 0 1 1 1 1 1 1 1 
1 -1 -1 -1 -1 11 -1 -1 -1 1 
1 1 1 13 13 1 1 1 -1 1 
-1 -1 11 -1 -1 -1 -1 -1 -1 1 
1 1 1 1 0 1 1 0 1 1 
---------------------------
0 0 0 0 0 0 0 0 0 0 
0 0 0 0 0 0 0 0 0 0 
0 0 0 0 0 0 0 0 0 0 
0 0 0 0 0 0 0 0 0 0 
0 0 0 0 0 0 0 0 0 0 
%%%%%%%%%%%%%%%%%%%%%%%%%%%%
