98
72
3
1
===========================
-1 10 13 13 13 13 13 13 13 1 
-1 -1 -1 -1 -1 -1 -1 -1 -1 1 
-1 -1 1 1 1 -1 1 1 1 1 
-1 1 1 12 1 1 1 1 1 1 
-1 1 1 1 1 1 1 1 1 1 
---------------------------
1 1 1 1 1 1 1 1 1 1 
1 1 1 1 1 1 1 1 1 1 
1 1 1 1 1 1 1 1 1 1 
1 1 1 27 1 1 1 1 1 1 
1 1 1 1 1 1 1 1 1 28 
%%%%%%%%%%%%%%%%%%%%%%%%%%%%
