88
60
2
1
===========================
-1 1 12 1 1 1 1 1 1 -1 
-1 1 -1 -1 -1 1 1 1 1 1 
-1 1 1 1 1 1 -1 -1 -1 -1 
-1 -1 -1 -1 -1 13 12 12 12 12 
-1 -1 -1 -1 1 2 -1 -1 -1 -1 
---------------------------
0 0 6 0 0 0 0 0 0 0 
0 0 0 0 0 0 0 0 0 0 
0 0 0 0 6 0 0 0 0 0 
0 0 0 0 0 0 19 17 5 6 
0 0 0 0 0 0 0 0 0 0 
%%%%%%%%%%%%%%%%%%%%%%%%%%%%
