81
63
0
0
===========================
1 13 1 1 1 1 1 1 1 1 
-1 -1 -1 -1 -1 -1 -1 -1 -1 1 
1 1 1 1 1 1 13 1 -1 1 
1 -1 -1 -1 -1 -1 -1 -1 -1 1 
13 1 1 1 1 1 1 1 13 1 
---------------------------
0 0 0 0 0 0 0 0 0 0 
0 0 0 0 0 0 0 0 0 0 
0 0 0 0 0 0 0 0 0 0 
0 0 0 0 0 0 0 0 0 0 
0 0 0 0 0 0 0 0 0 0 
%%%%%%%%%%%%%%%%%%%%%%%%%%%%
