92
64
4
6
===========================
1 1 1 1 1 -1 -1 -1 -1 -1 
1 1 1 1 1 2 11 11 1 1 
1 1 1 1 1 -1 -1 -1 1 1 
1 1 1 -1 1 -1 -1 -1 1 1 
1 3 1 -1 1 13 1 -1 1 1 
---------------------------
0 0 0 0 0 0 0 0 0 0 
0 0 0 0 0 0 0 0 0 0 
0 0 0 0 0 0 0 0 0 0 
0 0 0 0 0 0 0 0 0 0 
0 0 0 0 0 0 0 0 0 0 
%%%%%%%%%%%%%%%%%%%%%%%%%%%%
