71
21
0
0
===========================
11 13 -1 11 11 11 11 1 0 1 
11 11 11 11 13 -1 2 1 1 1 
13 -1 11 -1 -1 -1 1 0 1 1 
11 11 11 11 13 -1 1 1 3 1 
-1 -1 13 -1 -1 -1 1 1 1 0 
---------------------------
0 0 0 0 0 0 0 0 0 0 
0 0 0 0 0 0 0 0 0 0 
0 0 0 0 0 0 0 0 0 0 
0 0 0 0 0 0 0 0 0 0 
0 0 0 0 0 0 0 0 0 0 
%%%%%%%%%%%%%%%%%%%%%%%%%%%%
