80
50
2
5
===========================
1 1 1 1 1 1 1 1 1 1 
-1 -1 1 1 1 1 1 1 -1 -1 
-1 -1 -1 -1 1 0 -1 -1 -1 -1 
-1 -1 1 1 1 1 1 1 -1 -1 
1 1 1 1 1 1 1 1 1 1 
---------------------------
1 1 1 1 1 1 1 1 1 1 
1 1 1 1 1 1 1 1 1 1 
1 1 1 1 13 1 1 1 1 1 
1 1 1 1 1 1 1 1 1 1 
1 1 1 1 1 1 1 1 1 1 
%%%%%%%%%%%%%%%%%%%%%%%%%%%%
