72
26
4
5
===========================
11 11 11 11 11 11 11 11 11 11 
1 1 3 3 1 -1 13 13 -1 1 
1 1 -1 -1 1 1 -1 -1 1 1 
1 -1 13 13 -1 1 3 3 1 1 
11 11 11 11 11 11 11 11 11 11 
---------------------------
0 0 0 0 0 0 0 0 0 0 
0 0 0 0 0 0 0 0 0 0 
0 0 0 0 0 0 0 0 0 0 
0 0 0 0 0 0 0 0 0 0 
0 0 0 0 0 0 0 0 0 0 
%%%%%%%%%%%%%%%%%%%%%%%%%%%%
