94
30
2
0
===========================
13 1 1 1 1 12 -1 -1 -1 -1 
11 0 -1 1 1 1 12 -1 -1 -1 
11 13 0 1 0 1 1 12 -1 -1 
11 1 -1 -1 13 0 1 12 -1 -1 
13 1 1 1 0 1 12 -1 -1 -1 
---------------------------
1 1 1 1 1 5 1 1 1 1 
1 1 1 1 1 1 10 1 1 1 
1 1 1 1 1 1 1 17 1 1 
1 1 1 1 1 1 1 17 1 1 
1 1 1 1 1 1 19 1 1 1 
%%%%%%%%%%%%%%%%%%%%%%%%%%%%
