59
23
0
0
===========================
11 11 11 11 11 -1 1 -1 -1 -1 
11 -1 11 -1 11 1 3 1 -1 -1 
11 -1 1 -1 -1 -1 1 -1 -1 -1 
11 1 2 1 11 11 11 -1 -1 1 
-1 -1 1 -1 -1 -1 11 11 1 4 
---------------------------
0 0 0 0 0 0 0 0 0 0 
0 0 0 0 0 0 0 0 0 0 
0 0 0 0 0 0 0 0 0 0 
0 0 0 0 0 0 0 0 0 0 
0 0 0 0 0 0 0 0 0 0 
%%%%%%%%%%%%%%%%%%%%%%%%%%%%
