68
58
0
0
===========================
12 12 -1 -1 1 1 1 1 1 1 
12 12 -1 -1 -1 1 1 1 1 1 
-1 11 -1 -1 -1 11 -1 1 1 1 
1 1 1 11 1 1 -1 -1 1 1 
1 1 1 -1 1 1 1 -1 -1 -1 
---------------------------
28 27 0 0 0 0 0 0 0 0 
29 30 0 0 0 0 0 0 0 0 
0 0 0 0 0 0 0 0 0 0 
0 0 0 0 0 0 0 0 0 0 
0 0 0 0 0 0 0 0 0 0 
%%%%%%%%%%%%%%%%%%%%%%%%%%%%
