96
25
0
6
===========================
-1 -1 -1 -1 -1 -1 1 -1 -1 -1 
-1 -1 -1 13 1 1 13 1 1 1 
-1 -1 -1 1 -1 -1 1 -1 -1 -1 
1 1 1 1 13 8 13 -1 -1 -1 
-1 -1 -1 -1 -1 -1 -1 -1 -1 -1 
---------------------------
0 0 0 0 0 0 0 0 0 0 
0 0 0 0 0 0 0 0 0 0 
0 0 0 0 0 0 0 0 0 0 
0 0 0 0 0 0 0 0 0 0 
0 0 0 0 0 0 0 0 0 0 
%%%%%%%%%%%%%%%%%%%%%%%%%%%%
