89
50
0
0
===========================
1 1 1 1 1 -1 -1 -1 1 1 
1 -1 11 -1 1 -1 1 1 1 -1 
13 11 0 11 1 13 1 -1 11 0 
1 -1 11 -1 1 -1 1 1 1 -1 
1 1 1 1 1 -1 -1 -1 1 1 
---------------------------
0 0 0 0 0 0 0 0 0 0 
0 0 0 0 0 0 0 0 0 0 
0 0 0 0 0 0 0 0 0 0 
0 0 0 0 0 0 0 0 0 0 
0 0 0 0 0 0 0 0 0 0 
%%%%%%%%%%%%%%%%%%%%%%%%%%%%
