86
44
0
8
===========================
-1 -1 -1 -1 -1 -1 -1 1 12 -1 
-1 -1 -1 -1 0 0 0 12 1 -1 
-1 -1 1 12 1 1 1 1 1 -1 
1 1 1 1 12 12 1 1 12 -1 
-1 -1 -1 -1 -1 -1 -1 -1 -1 -1 
---------------------------
0 0 0 0 0 0 0 0 4 0 
0 0 0 0 0 0 0 4 0 0 
0 0 0 3 0 0 0 0 0 0 
0 0 0 0 11 22 0 0 15 0 
0 0 0 0 0 0 0 0 0 0 
%%%%%%%%%%%%%%%%%%%%%%%%%%%%
