91
16
0
0
===========================
13 13 13 13 13 13 13 13 -1 -1 
13 13 13 1 13 13 13 13 -1 -1 
13 1 13 0 13 0 1 13 -1 -1 
13 1 13 1 13 1 1 13 -1 -1 
13 13 13 13 13 13 13 13 -1 -1 
---------------------------
0 0 0 0 0 0 0 0 0 0 
0 0 0 0 0 0 0 0 0 0 
0 0 0 0 0 0 0 0 0 0 
0 0 0 0 0 0 0 0 0 0 
0 0 0 0 0 0 0 0 0 0 
%%%%%%%%%%%%%%%%%%%%%%%%%%%%
