51
24
0
0
===========================
11 11 -1 -1 1 1 1 -1 -1 1 
0 13 1 1 -1 11 -1 -1 -1 13 
1 11 -1 1 -1 11 -1 -1 -1 1 
1 11 1 1 1 11 1 1 1 1 
-1 0 -1 -1 -1 -1 -1 -1 -1 -1 
---------------------------
0 0 0 0 0 0 0 0 0 0 
0 0 0 0 0 0 0 0 0 0 
0 0 0 0 0 0 0 0 0 0 
0 0 0 0 0 0 0 0 0 0 
0 0 0 0 0 0 0 0 0 0 
%%%%%%%%%%%%%%%%%%%%%%%%%%%%
