53
25
4
2
===========================
13 11 11 13 13 13 13 11 11 13 
1 1 1 1 -1 -1 1 1 1 1 
1 1 1 1 0 0 1 1 1 1 
1 1 1 1 -1 -1 1 1 1 1 
13 11 11 13 13 13 13 11 11 13 
---------------------------
0 0 0 0 0 0 0 0 0 0 
0 0 0 0 0 0 0 0 0 0 
0 0 0 0 0 0 0 0 0 0 
0 0 0 0 0 0 0 0 0 0 
0 0 0 0 0 0 0 0 0 0 
%%%%%%%%%%%%%%%%%%%%%%%%%%%%
