52
32
0
0
===========================
11 11 -1 -1 1 1 1 -1 -1 1 
0 13 1 1 -1 11 -1 -1 -1 13 
1 11 -1 1 -1 11 -1 -1 -1 1 
13 11 1 1 1 11 1 1 1 1 
-1 12 -1 -1 -1 -1 -1 -1 -1 11 
---------------------------
0 0 0 0 0 0 0 0 0 0 
0 0 0 0 0 0 0 0 0 0 
0 0 0 0 0 0 0 0 0 0 
0 0 0 0 0 0 0 0 0 0 
0 17 0 0 0 0 0 0 0 0 
%%%%%%%%%%%%%%%%%%%%%%%%%%%%
