60
34
3
7
===========================
-1 -1 -1 -1 1 1 -1 -1 -1 -1 
13 11 11 5 1 1 5 11 11 13 
-1 11 -1 1 1 1 1 -1 11 -1 
13 11 11 5 1 1 5 11 11 13 
-1 -1 -1 -1 1 1 -1 -1 -1 -1 
---------------------------
0 0 0 0 0 0 0 0 0 0 
0 0 0 0 0 0 0 0 0 0 
0 0 0 0 0 0 0 0 0 0 
0 0 0 0 0 0 0 0 0 0 
0 0 0 0 0 0 0 0 0 0 
%%%%%%%%%%%%%%%%%%%%%%%%%%%%
