79
38
2
4
===========================
11 11 11 13 1 13 11 11 11 11 
11 -1 -1 -1 1 -1 -1 -1 -1 11 
1 1 1 1 10 1 1 1 1 1 
11 -1 -1 -1 1 -1 -1 -1 -1 11 
11 11 11 13 1 13 11 11 11 11 
---------------------------
0 0 0 0 0 0 0 0 0 0 
0 0 0 0 0 0 0 0 0 0 
0 0 0 0 0 0 0 0 0 0 
0 0 0 0 0 0 0 0 0 0 
0 0 0 0 0 0 0 0 0 0 
%%%%%%%%%%%%%%%%%%%%%%%%%%%%
