66
53
0
5
===========================
1 1 6 1 1 11 1 1 12 -1 
-1 -1 1 -1 -1 1 -1 -1 -1 -1 
-1 -1 1 -1 -1 1 -1 -1 -1 -1 
-1 -1 1 -1 -1 1 -1 -1 -1 -1 
-1 -1 1 -1 -1 11 1 6 1 -1 
---------------------------
0 0 0 0 0 0 0 0 17 0 
0 0 0 0 0 0 0 0 0 0 
0 0 0 0 0 0 0 0 0 0 
0 0 0 0 0 0 0 0 0 0 
0 0 0 0 0 0 0 0 0 0 
%%%%%%%%%%%%%%%%%%%%%%%%%%%%
