85
50
4
4
===========================
-1 -1 -1 -1 1 2 -1 -1 -1 -1 
-1 -1 -1 -1 1 -1 -1 -1 -1 -1 
-1 -1 7 7 13 7 7 -1 -1 -1 
-1 -1 -1 1 1 1 -1 -1 -1 -1 
-1 -1 -1 -1 0 -1 -1 -1 -1 -1 
---------------------------
0 0 0 0 0 0 0 0 0 0 
0 0 0 0 0 0 0 0 0 0 
0 0 0 0 0 0 0 0 0 0 
0 0 0 0 0 0 0 0 0 0 
0 0 0 0 0 0 0 0 0 0 
%%%%%%%%%%%%%%%%%%%%%%%%%%%%
