54
26
4
5
===========================
11 11 -1 11 11 11 11 11 -1 -1 
11 2 -1 0 0 0 0 11 -1 -1 
11 0 0 0 0 0 0 12 -1 -1 
11 2 -1 0 0 0 0 11 -1 -1 
11 11 -1 11 11 11 11 11 -1 -1 
---------------------------
0 0 0 0 0 0 0 0 0 0 
0 0 0 0 0 0 0 0 10 0 
0 0 0 0 0 0 0 12 0 0 
0 0 0 0 0 0 0 0 20 0 
0 0 0 0 0 0 0 0 0 0 
%%%%%%%%%%%%%%%%%%%%%%%%%%%%
