90
34
3
4
===========================
-1 1 -1 -1 -1 -1 -1 -1 1 -1 
1 13 1 1 1 1 1 1 13 1 
-1 1 -1 -1 -1 -1 -1 -1 1 -1 
1 13 1 1 1 1 1 1 13 1 
-1 1 -1 -1 -1 -1 -1 -1 1 -1 
---------------------------
0 0 0 0 0 0 0 0 0 0 
0 0 0 0 0 0 0 0 0 0 
0 0 0 0 0 0 0 0 0 0 
0 0 0 0 0 0 0 0 0 0 
0 0 0 0 0 0 0 0 0 0 
%%%%%%%%%%%%%%%%%%%%%%%%%%%%
