73
30
0
0
===========================
1 0 -1 -1 -1 -1 -1 -1 1 0 
0 0 -1 -1 -1 -1 -1 -1 1 1 
0 12 11 11 11 11 11 11 12 1 
0 0 -1 -1 -1 -1 -1 -1 1 1 
0 0 -1 -1 -1 -1 -1 -1 1 0 
---------------------------
0 0 0 0 0 0 0 0 0 0 
0 0 0 0 0 0 0 0 0 0 
0 10 0 0 0 0 0 0 10 0 
0 0 0 0 0 0 0 0 0 0 
0 0 0 0 0 0 0 0 0 0 
%%%%%%%%%%%%%%%%%%%%%%%%%%%%
