70
60
2
4
===========================
4 1 1 1 13 13 1 1 1 4 
1 11 -1 -1 -1 -1 -1 -1 11 1 
13 1 1 1 11 11 1 1 1 13 
1 11 -1 -1 -1 -1 -1 -1 11 1 
4 1 1 1 13 13 1 1 1 4 
---------------------------
0 0 0 0 0 0 0 0 0 0 
0 0 0 0 0 0 0 0 0 0 
0 0 0 0 0 0 0 0 0 0 
0 0 0 0 0 0 0 0 0 0 
0 0 0 0 0 0 0 0 0 0 
%%%%%%%%%%%%%%%%%%%%%%%%%%%%
