62
22
4
9
===========================
1 1 1 1 1 1 1 1 1 11 
1 1 1 1 1 1 1 11 11 11 
1 1 1 1 1 11 13 13 13 11 
1 1 1 11 11 11 13 12 13 11 
1 11 11 11 11 11 13 13 13 11 
---------------------------
0 0 0 0 0 0 0 0 0 0 
0 0 0 0 0 0 0 0 0 0 
0 0 0 0 0 0 0 0 0 0 
0 0 0 0 0 0 0 24 0 0 
0 0 0 0 0 0 0 0 0 0 
%%%%%%%%%%%%%%%%%%%%%%%%%%%%
